Баня	драма
Бесприданница	драма
Власть тьмы, или 'коготок увяз, всей птичке          пропасть'	драма
Гроза	драма
Дело	драма
Дети Ванюшина	драма
Живой труп	драма
Иванов	драма
Маскарад	драма
Татьяна Репина	драма
Три сестры	драма
Горькая судьбина	драма
Американцы	комедия
Бедность не порок	комедия
Блонды	комедия
Бригадир	комедия
Вишневый сад	комедия
Волки и овцы	комедия
Где тонко, там и рвётся	комедия
Горе от ума	комедия
Женитьба	комедия
Завтрак у предводителя	комедия
Иван Васильевич	комедия
Лакейская	комедия
Лес	комедия
Леший	комедия
Медведь	комедия
Нахлебник	комедия
Не любо – не слушай, а лгать не мешай	комедия
Недоросль	комедия
Неосторожность	комедия
Подщипа или Трумф	комедия
Предложение	комедия
Провинциалка	комедия
Пустодомы	комедия
Ревизор	комедия
Свадьба Кречинского	комедия
Свои люди – сочтемся	комедия
Своя семья, или замужняя невеста	комедия
Сговор Кутейкина	комедия
Смерть Тарелкина	комедия
Сонный порошок или похищенная крестьянка	комедия
Спор древних греческих философов об изящном	комедия
Трагик поневоле (Из дачной жизни)	комедия
Тяжба	комедия
Урок дочкам	комедия
Урок кокеткам, или липецкие воды	комедия
Утро делового человека	комедия
Холостяк	комедия
Чайка	комедия
Черепослов, сиречь Френолог	комедия
Юбилей	комедия
Игроки	комедия
Борис Годунов	трагедия
Демофонт	трагедия
Димитрий Донской	трагедия
Димитрий Самозванец	трагедия
Семира	трагедия
Смерть Иоанна Грозного	трагедия
Тамира и Селим	трагедия
Хорев	трагедия
Царь Борис	трагедия
Царь Фёдор Иоаннович	трагедия